Иванов Иван Иванович: плетение (бисер, корзины, коробочки, кружева, макраме…), лыжи, игрушки и куклы
Петров Петр Петрович: пейнтбол, вязание
Андрианов Даниил Артёмович: коллекционирование
Воронин Гордей Евгеньевич: аэробика, дерево
Соловьев Андрей Артёмович: выращивание кристаллов, дайвинг
Герасимова Ангелина Артёмовна: автомобили, психология и тренинги
Титова Дарина Никитична: робототехника, граффити, дизайн интерьера
Власова Екатерина Алексеевна: батик
Васильева Катерина Тимофеевна: диггерство
Иванова Анна Романовна: изучение новых компьютерных программ, головоломки, жонглирование
Воронцова Мария Денисовна: спорт-фанат
Гришина Вероника Матвеевна: дайвинг, игры на компьютерах и приставках, гербарий
Сафонов Дмитрий Алексеевич: бег, пейнтбол
Белкин Матвей Иванович: кулинария, танцы и балет, предпринимательство
Муравьева Анастасия Максимовна: изделия из металла и кузнечное дело, переписка по обычной почте
Фролова Ксения Михайловна: дайвинг, ароматерапия
Виноградова Ксения Альбертовна: радиовещание, косплей
Волкова Лейла Марковна: писательская деятельность и журналистика, собирание грибов и ягод
Сотникова Маргарита Данииловна: пейнтбол, астрономиякартинг и квадроциклы
Карпова Софья Марковна: получение научных званий и степеней, страйкбол, пение и караоке
Васильева Екатерина Александровна: разработка сайтов, животные (разведение и уход), скрапбукинг
Любимов Кирилл Михайлович: боевые искусства, робототехника, бадминтон
Миронова Алиса Ивановна: дерево (выжигание и резьба), кроссворды (составление и разгадывание)
Смирнова Надежда Александровна: шитье и вышиваниеавтомобили
Александров Руслан Максимович: изделия из металла и кузнечное дело
Лобанова Александра Андреевна: петанк
Бирюков Али Маратович: зентангл, бильярд
Волков Кирилл Захарович: блоггерство, лошади (верховая езда, уход)
Литвинов Вячеслав Русланович: паркур
Черкасова София Тихоновна: предпринимательство, плетение
Ершов Елисей Никитич: файер-шоу, скрапбукинг
Козлова Фатима Марковна: рукоделия из кожи, петанк, рисование (акварель, холст, бумага, карандаши, стекло, гуашь и т.п.)
Кудрявцева Елизавета Викторовна: картинг и квадроциклы, иностранные языки
Малышев Даниил Леонидович: пчеловодство, рисование
Симонов Евгений Ильич: видеомонтаж
Громов Михаил Марсельевич: силовые тренировки, собирание грибов и ягод
Антонов Владимир Даниилович: аэрография, горные лыжи
Кудрявцев Фёдор Михайлович: пилатес
Морозова Милана Алексеевна: игры на компьютерах и приставках, массаж
Ткачев Владимир Андреевич: теннис
Попова Екатерина Всеволодовна: лепка, плетение (бисер, корзины, коробочки, кружева, макраме…)
Дубинина Есения Захаровна: музыка
Терехов Тихон Адамович: файер-шоу, парашютный спорт, боулинг
Калугина Виктория Семёновна: лыжи, предпринимательство, зентангл
Герасимова Аиша Константиновна: гольф, оригами
Архипова Полина Станиславовна: иностранные языки, каллиграфия
Котова Ярослава Максимовна: музеи и выставки, кроссворды (составление и разгадывание)
Суворова Диана Григорьевна: открытки, музеи и выставки, астрономия
Попова Таисия Александровна: самодельные (handmade) вещи: одежда, обувь, аксессуары, дайвинг
Пономарева Таисия Львовна: кайтинг
Кузьмина Алисия Максимовна: файер-шоу
Лебедев Дмитрий Дмитриевич: скрапбукинг (фотоальбомы своими руками), фокусы
Горшков Александр Львович: танцы и балет
Ковалев Даниил Григорьевич: татуировки и пирсинг, изучение новых компьютерных программ
Масленников Лука Александрович: плавание, компьютерная графика (дизайн, 3d, flash, спецэффекты и т.д.)
Зимин Николай Кириллович: лыжи, открытки (изготовление своими руками, обмен (посткроссинг))
Лапин Лев Романович: боевые искусства, батик
Марков Давид Львович: переписка по обычной почте, моделирование
Ефимова Варвара Германовна: фейерверки, разработка сайтов, аэрография
Шульгин Марк Николаевич: автомобили
Зверев Антон Глебович: исторические реконструкции, пикап, иностранные языки
Родина Дарья Алексеевна: пилатес, выращивание растений и цветов, пикап
Ермолова Дарья Марковна: кулинария, фейерверки, велосипед
Баранова Дарья Александровна: блоггерство, выращивание растений и цветов, карвинг
Смирнов Матвей Борисович: плавание
Яковлев Артём Николаевич: выращивание кристаллов
Калмыков Адам Семёнович: изделия из металла и кузнечное дело
Шарова Елизавета Сергеевна: каллиграфия, пение и караоке, разработка сайтов
Иванова Милана Никитична: блоггерство
Васильева Алиса Андреевна: скрапбукинг, танцы и балет, массаж
Ефремова Вероника Ярославовна: переписка по обычной почте, блоггерство, файер-шоу
Олейников Роман Святославович: паззлы, пикап
Титов Иван Тимурович: животные (разведение и уход), горные лыжи
Козлова Анна Михайловна: театр (театральный кружок)
Суслова Елизавета Егоровна: зентангл, моделирование
Белова Василиса Марковна: пчеловодство, сноуборд
Емельянов Максим Даниилович: вязание, гольф
Кулешов Лука Максимович: плавание, батут
Смирнов Максим Александрович: рисование по номерам, плавание
Новикова Анна Елисеевна: ароматерапия, массаж, бильярд
Третьяков Эмиль Георгиевич: кладоискательство и археология, кайтинг, граффити
Королева Варвара Артёмовна: кроссворды, выращивание растений и цветов
Борисова Екатерина Владимировна: парашютный спорт, аэробика, разработка сайтов
Сорокина Елизавета Алексеевна: пчеловодство, спорт-фанат
Потапова Евгения Ивановна: музыка
Щербаков Константин Денисович: парашютный спорт
Зайцев Антон Артёмович: изделия из металла и кузнечное дело
Жданов Захар Арсентьевич: аэробика, видеомонтаж, массаж
Блохина Амина Никитична: музеи и выставки, плавание
Бирюкова Елизавета Арсентьевна: дизайн интерьера, рисование
Гуляева Анна Савельевна: скрапбукинг, видеомонтаж, пикап
Зайцев Никита Даниилович: кроссворды
Денисов Андрей Ярославович: музыка, игрушки и куклы, животные (разведение и уход)
Смирнова Варвара Никитична: музеи и выставки
Маслов Михаил Михайлович: каллиграфия, бонсай, дизайн интерьера
Капустина Маргарита Семёновна: исторические реконструкции
Ильина Виктория Михайловна: рисование, дизайн интерьера, квест-комнаты
Гусев Даниил Родионович: пение и караоке
Никонов Егор Тимофеевич: боулинг, плавание, игры на компьютерах и приставках
Мальцева Елизавета Васильевна: собирание грибов и ягод, лазертаг
Рябинин Павел Евгеньевич: дартс, сноуборд
Сергеев Евгений Денисович: диггерство, боулинг, фейерверки
Морозова Арина Константиновна: вязание
Никитина Мария Александровна: рисование по номерам
Титова Юлия Степановна: выращивание кристаллов
Смирнов Артур Максимович: плетение
Семенов Илья Максимович: бег
Ковалев Артём Олегович: ароматерапия, пилатес
Петров Арсений Константинович: пение и караоке, коньки и ролики, разработка сайтов
Филатов Кирилл Арсентьевич: игра на музыкальных инструментах (пианино, гитара, труба,…), боулинг
Герасимова Виктория Артёмовна: бонсай, танцы и балет
Петрова Ольга Романовна: оригами, игры на компьютерах и приставках
